##################
#  .             #
# ##           ###
#          # $   #
#          ##  ###
#      @     #####
#                #
##################